1. part
    That is the part of the lamp: Đó là một bộ phận của chiếc đèn.
    Does he know this part of the city?: Anh ấy biết phần này của thành phố phải không?
2. view
    The view from the castle is perfect: Phong cảnh từ tòa lâu đài thì hoàn hảo.
    This is the view from her home: Đây là góc nhìn từ nhà của cô ấy.

3. system
    We use a different system: Chúng tôi sử dụng một hệ thống khác.
    He creates systems: Anh ấy tạo ra những hệ thống.
    The engineer explains the system: Kỹ sư giải thích hệ thống.

4. review
    Her book receives a positive review: Cuốn sách của cô ấy nhận được một đánh giá tích cực.
    He liked my review.: Anh ấy đã thích bài đánh giá của tôi.

5. love
    He is my first love: Anh ấy là tình yêu đầu tiên của tôi.
    She is in love with my brother: Cô ấy đang yêu anh trai của tôi.
    I am in love: Tôi đang yêu!

6. service
    I never use their service: Tôi không bao giờ sử dụng dịch vụ của họ.
    Is there a bus service?: Có dịch vụ xe buýt không?

7. list
    My name appears on the list: Tên của tôi xuất hiện trên danh sách.
    He reads the wine list: Anh ấy đọc danh sách rượu vang.

8. version
    The English version is perfect: Phiên bản tiếng Anh thì hoàn hảo.
    I want to see another version of this document.: Tôi muốn xem phiên bản khác của văn bản này.
    There are two versions on the computer: Có hai phiên bản trên máy tính.

8. design
    She likes the design on the plate: Cô ấy thích thiết kế trên chiếc dĩa.
    He likes the menu design: Anh ấy thích cách thiết kế cái thực đơn.

9. case
    In this case, call the police: Trong trường hợp này, gọi cảnh sát. (in this case)
    Take the umbrella in case it rains: Đem cái dù phòng khi trời mưa. ( in case)


10. order: đơn hàng, yêu cầu
    This is my order.
    This is the last order: Đây là yêu cầu cuối cùng.

11. type
    there are many types of books: Có nhiều loại sách.
    I like this type of shoe: Tôi thích loại giầy này.
    It is a type of education: Nó là một loại hình của giáo dục.

12. way
    I like the way you walk: Tôi thích cách bạn đi.
    I was born this way: Tôi đã được sinh ra như vậy.

13. group
    Our group travels to China: Nhóm của chúng tôi du lịch Trung Quốc.
    We must play in a group
    The groups change after about three to four weeks: Các nhóm thay đổi sau khoảng ba tới bốn tuần.

14. member
    No member drinks wine: Khong co thanh vien uong ruou
    Each group has three members.: Moi nhom co ba thanh vien

15. profile
    The actor has a famous profile: Dien vien co tieu su noi tieng

16. account
    Here's is my account number: Day la so tai khoan cua toi.
    I have an account at that bank: Tôi có một tài khoản ở ngân hàng đó .
    How do we take it into account: Lam sao chung ta co the chiếu cố đến nó? (take something into account: chiếu cố cái gì đó)

17. change
    I need change
    Over time everything changes: Qua thoi gian moi thu thay doi.

18. call
    The call is from your mother.

19. control
    I have everything under control.: Toi co moi thu trong kiem soat
    She wants to be in control of the group: Cô ấy muốn quản lý nhóm.

20. level
    He is not at my level: Anh ta không cùng trình độ với tôi.

21. acts:
    I am not sorry for my acts: Tôi không xin lỗi cho những hành vi của tôi.
    He explains his act.
    It is just an act: No chi la mot su gia vo

22. image
    She explained her ideas with images: Cô ấy đã giải thích những ý tưởng của mình bằng những hình ảnh.
    I like this image: Tôi thích hình ảnh này .
    How do I add images to my page: Làm thế nào tôi thêm những hình ảnh vào trang của tôi ?

23. content
    We are not responsible for the content: Chúng tôi không chịu trách nhiệm cho nội dung .
    the content: Noi dung.

24. equiment
    He has professional equipment: Anh ấy có thiết bị chuyên nghiệp.
    How to play without equipment?: Làm sao mà chơi khi không có dụng cụ?

25. description
    My husband likes this description: Chồng tôi thích sự mô tả này .
    He gave a description about the party: Anh ấy đã đưa một mô tả về bữa tiệc.

26. value
    The value of the motorcycle is in the book: Giá trị của chiếc xe máy thì ở trong cuốn sách.
    An object contains a value: Một vật thể chứa đựng một giá trị .

27. category
    Cheese and milk are in the same category: Phô mai và sữa là cùng thể loại .
    There are five categories: 

28. behavior
    I am not sorry for my behavior: Tôi không hối tiếc về những hành vi của tôi.

29. side
    I walk by her side: Tôi đi bộ cạnh cô ấy.
    He listened to both sides: Anh ấy đã lắng nghe cả 2 bên .

30. option
    The option: Lựa chọn
    Is there any another option? Có sự lựa chọn nào khác không ?
    We have three options: Chúng tôi có ba tùy chọn .

31. result
    This book is the result : Cuốn sách này là kết quả.
    We have results: Chúng tôi có những kết quả.

32. activity
    There are many activities at the fair: Có nhiều hoạt động ở hội chợ.
    This activity is open to the public: Hoạt động này mở cửa cho công chúng

33. issue
    What is the issue: Vấn đề là gì?
    This issue has nothing to do with you.: Vấn đề này không liên quan đến bạn. (has nothing to do with)

34. problem
    No problem: Không vấn đề!

35. Over    
    The performance was almost over: Màn trình diễn đã gần kết thúc.

36. agreement
    Every agreement is impossible: Mọi thỏa thuận đều không khả thi .
    We need to come to an agreement: Chúng tôi cần đi đến một thỏa thuận.

37. protection
    You are under my protection: ban dang trong su bao ve cu toi.
    They need our protection: Họ cần sự bảo vệ của chúng ta .

39. production
    I am in the production department: Tôi ở phòng sản xuất.
    Coffee is the main production of Brazil:  Cà phê là sự sản xuất chính ở nước Brazil .

40. response
    Each student has a different response: Mỗi học sinh có một câu trả lời khác nhau.
    There was no response to my question: Đã không có câu trả lời nào cho câu hỏi của tôi.

41. solution
    we have a couple of solutions to this issue: Chúng tôi có vài giải pháp cho vấn đề này.
    She does not offer a solution however.: Tuy nhiên cô ấy không đưa ra một giải pháp .
    He finally found a solution to solve to his issue: Cuối cùng anh ta đã tìm ra một cách giải quyết cho vấn đề của mình .

42. construction
    The construction has twenty floors: Công trình xây dựng có 20 tầng.
    The construction of the school starts next week: Sự xây dựng của ngôi trường bắt đầu vào tuần sau.
    the museum is under construction: Viện bảo tàng đang được xây dựng.

43. hope(n): hi vọng
    The hope: hi vọng
    You are our hope: Bạn là hi vọng của chúng tôi.
    There is hope: Có hi vọng

44. mind
    You have to open your mind: Bạn phải mở rộng đầu óc của bạn .
    He is out of his mind.: Anh ta mất trí rồi .

45. entry: Lối vào.
    I see the entry: Tôi nhìn thấy lối vào. 
    The book has many entries: Cuốn sách có rất nhiều mục .

46. opportunity
    We have no opportunity to use English: Chúng tôi không có cơ hội để sử dụng tiếng Anh.
    The opportunities: Những cơ hội.

47. union: hiệp hội, sự hợp nhất.
    Everybody wants union in the country.: Mọi người muốn có sự hợp nhất trong đất nước.
    The union believes that everybody has the same rights: Hiệp hội tin rằng mỗi người có quyền lợi như nhau.

48. effect(n): hiệu ứng, tác dụng

49. wish(n) : điều ước
    We respect the wishes of the victim.: Chúng tôi tôn trọng những ước nguyện của nạn nhân.

50. degree: Bằng cấp, nhiệt độ
    It is ten degrees this morning: Trời thì mười độ sáng nay.
    The degree takes four or five years: Cái bằng mất bốn hoặc năm năm .

51. purpose: mục dích
    My trip has a purpose: Chuyến đi của tôi có một mục đích.
    What is the purpose of your visit: Mục đích chuyến thăm của bạn là gì?
    She did it on purpose: Cô ta đã cố tình làm nó.

52. evidence: bằng chứng
    There is no historical evidence: Không có bằng chứng lịch sử .
    This is evidence!: Đây là bằng chứng!

53. matter: Vấn đề
    It is only a matter of time: No chỉ là vấn đề thời gian.
    You have no choice in this matter: Bạn không có sự lựa chọn trong vấn đề này.
    We must study the matter: Chúng tôi phải nghiên cứu vấn đề.

54. role: Vai trò
    The role: Vai trò
    I have a perfect role for you: Tôi có vai trò hoàn hảo cho bạn.
    He played an important role on the committee: Anh ta đã đóng một vai trò quan trọng trong uỷ ban

55. voie: giọng nói.
    She has a beautiful voice: Cô ấy có một giọng nói đẹp .
    She has a nice voice: Cô ấy có một giọng nói hay.
    Have you lost your voice? : Bạn đã mất đi giọng nói của mình à ?

56. choice: sự lựa chọn
    My choice is different from yours: Sự lựa chọn của tôi thì khác của bạn.

57. grade : Lớp
    I am a fourth grade teacher: Tôi là một giáo viên lớp bốn.
    
58. introduction : sự giới thiệu, lời giới thiệu
    Introduction from the author: Lời giới thiệu từ tác giả
    Who wrote the introduction: Ai đã viết lời mở đầu ?

59. charge:
    My phone is out of charge: Điện thoại của tôi hết pin.

60. awards:
    He won four awards: Anh ấy đã chiến thắng 4 giải .
    The award is on the wall: Giải thưởng ở trên tường.

61. route: đường đi, tuyến đường, lộ trình.
    The route to success: Lộ trình đến thành công.

62. subject: chủ đề, đề tài, môn học
    What is the subject of the book?: Chủ đề của cuốn sách là gì ?
    What subjects do you study at school?: Bạn học những môn gì ở trường học?

63. rest: nghỉ ngơi
    I want to take a rest:  muốn nghỉ ngơi.
    I want to have a rest: Tôi muốn được nghỉ ngơi.
    We wants the rest of my bread: Anh ấy muốn chỗ bánh mì còn lại của tôi.

64. topic: Chủ đề
    Do not change the topic: Đừng thay đổi chủ đề.

65. battery: pin
    My phone is out of battery: Điện thoại của tôi hết pin.

66. success
    This explains his success: Điều này giải thích sự thành công của anh ta.
    the book was an international success: Điều này giải thích sự thành công của anh ta.

67. edge: mép, rìa, bờ
    Water's edge: mép nước.
    I see the edge of the building: Tôi nhìn thấy mép của tòa nhà.

69. alternative/ɒlˈtɜː.nə.tɪv/: sự thay thế, lựa chọn khác
    We do not have an alternative: Chúng tôi không có sự lựa chọn khác.
    I saw him as an alternative: Tôi đã xem anh ấy như một sự thay thế.

70. kind
    It is a kind of fruit: Nó là một loại hoa quả.
    It is very kind of you: Bạn rất tốt bụng
    This is a kind of tomato: Đây là một loại cà chua.

71. record: Hồ sơ, ghi âm, kỉ lục, đĩa nhạc
    The police have your record: Cảnh sát có hồ sơ của bạn.
    His name is not in the records: Tên của anh ấy không có trong các hồ sơ.
    Put another record on!: Đặt đĩa nhạc khác lên!

72. dark: bỏng tối, đêm
    The child is afraid of the dark: Đứa trẻ sợ bóng tối.